...###
..##.#.####
.###.###.##
##........#
#..#@..#..#
###..##...#
..#..#....#
.##....#.##
.#......##
.#.....##
.#######